*********#**#*#***#**********#**#*#***#*#
#**#*****#**#*#*****#**#*****#**#*#*****#
##**##****#*****##*###**##****#*****##*#*
#****#****#*#*****#*##**##****#*****##*##
###***#******#****###****#****#*#*****#**
***##****#*#*****#*####***#******#****##*
**##*******#*#***#*****##****#*#*****#*##
##****####******#**#**##*******#*#***#**#
###**##******##*****##****####******#**##
*****#S**##*#******####**##******##*****#
*****#****#*##**#********##**##*#******##
*#***#**###*#*##*********#****#*##**#****
#******#**#*********#******#**#**********
**##******#****##*#**#***#**###*#*##*****
#*#***#*#***#**##*#***##******#****##*#*#
*##**##*******#****##*#***#*#***#**##*#*#
*##*##***#*#**#*#**#*##**##*******#****##
#***#*##***#*#*#***#*##*##***G*#**#*#**##
*##****####*##*******##****####*##******#
*****#**************#***#*##***#*#*#***##