#######################
**********************#
*#########*#**####**##*
*#******#***********#*#
*#*####*##*###*#*##*#*#
*#*####*##*###*#*##*#*#
*#******##*#******#*###
*#########G#####S######
**********#############
#######################
**********************#
*#########*#**####**##*
*#******#***********#*#
*#*####*##*###*#*##*#*#
*#*####*######*#*##*#*#
*#******##*#####**#*###
*#########*############
#####*****#############