###########
#*S**#***##
#****#****#
##*******##
#***##*####
#**##G***##		
###########