#################
#*S##G*##****####
#**###*##*##*##*#
#*##***##*##**#*#
#****#*##**##*#*#
#*####*###*##*#*#
#******#***####*#
######***#****###
#################