*******#*#**#*********#*******#*******#****##*###******###*##***##**#********************#***#*#**#*
#******##******#****#***#***********###*#**#***##**********#*****#*#*#****###**#***********#****#***
*#***####***#******##*##**#**####*****#*#*##*****#******#*********#*#*#*#S#**#****##*##*#**#*##*#***
*********#****###**#*****##*##*****#*##***#****#***#****#*#*##***#******#***#****#***###***#*******#
#***#**##**#**#***#****##*******##*****G#*#*****##*******##***************#****#*#*****#********#**#
**#*#*********#****#*#**#***#*#*##*****#*##*****##***#***##*###**#**##*##*****#********#*#***##**#*#
##*#*#**###*####*###***#*##**#*#****#**********##***#**##*#*#*****#*#**#*##********##*****#*****##**
**##*#****##**##**#**#***#******#****#**###***#******#*##**#********###**#**#********#******#**####*
**###*#***#**********#**##************##********#*#*****#**##****************###*#*##**********#****
**********#****#*****#***###***#*****#*#*#*#**#**##****#*#***#*******#****#********#********#*#*****
#***######***#***********#**#****#******#***#**###*****#**#*##*******#*#*****#********#*********#*#*
*##*****##***#*##*******#******************#****#*#***##***#*#**#*********#****##**#****#****#*###**
**#**#*#**#*###*******#******#*****##*##***#***#*#******##**#********#*#****************#**##****###
******#*****#*##*#*****#*##***#*##*##******#*#*#*#******###***#**#********#*********###*#**#*****#**
##*#*******#*#*#**##**#***##*##**#*#*********##*##*#*#***#***##*#***##*##***#*************#**##*****
*****##****##***#*********###****#******#*#*#*******#*#*****#*##**##**#***##****#*#******#**#*##****
*###*##*#**###*********#*#**#**********##****#******####***#*##*#****#**#*##***#******#**#*********#
*#*#*#*#*#***##*#************************#***#*#*#***##***#*#******##*##*#******#******#********###*
#*#*#**#*#****#**#**#****#*#*******#*#****#****#*#*#****##******#*#**#*#*****#****#***************##
#*#******#*************#**#*#****##*##********#********##*##************#*#*****#**#********####**#*